,Field of Study,Total,Men,Women,Year,Percent Men,Percent Women
0,all fields,1237875,530367,707508,2000,42.84,57.16
1,agriculture,5883,3970,1913,2000,67.48,32.52
2,agriculture,8656,4250,4406,2000,49.1,50.9
3,architecture,8462,5193,3269,2000,61.37,38.63
4,"area, ethnic, cultural studies",6381,2064,4317,2000,32.35,67.65
5,biological sciences,63532,26504,37028,2000,41.72,58.28
6,business,253162,127783,125379,2000,50.47,49.53
7,communications,55760,21289,34471,2000,38.18,61.82
8,communications technology,1150,774,376,2000,67.3,32.7
9,computer science,36195,26042,10153,2000,71.95,28.05
10,natural resources,9708,5630,4078,2000,57.99,42.01
11,education,108168,26124,82044,2000,24.15,75.85
12,engineering,58427,46525,11902,2000,79.63,20.37
13,engineering,13872,12386,1486,2000,89.29,10.71
14,english language and literature,50920,16341,34579,2000,32.09,67.91
15,foreign languages,14968,4375,10593,2000,29.23,70.77
16,health professions,78458,12727,65731,2000,16.22,83.78
17,home economics,17328,1962,15366,2000,11.32,88.68
18,law,1925,520,1405,2000,27.01,72.99
19,liberal arts,36104,12250,23854,2000,33.93,66.07
20,library science,154,77,77,2000,50.0,50.0
21,marketing operations marketing and distribution,4178,1652,2526,2000,39.54,60.46
22,mathematics,12070,6382,5688,2000,52.87,47.13
23,multi/interdisciplinary studies,27460,9136,18324,2000,33.27,66.73
24,parks and recreation,19111,9170,9941,2000,47.98,52.02
25,personal and miscellaneous services,369,229,140,2000,62.06,37.94
26,philosophy and religious studies,8366,5228,3138,2000,62.49,37.51
27,physical sciences,18213,10871,7342,2000,59.69,40.31
28,protective services,24877,14069,10808,2000,56.55,43.45
29,psychology,74060,17430,56630,2000,23.53,76.47
30,public administration,20185,3816,16369,2000,18.91,81.09
31,social sciences,127101,62062,65039,2000,48.83,51.17
32,theology,6809,4791,2018,2000,70.36,29.64
33,transportation,3395,2985,410,2000,87.92,12.08
34,visual and performing arts,58791,24003,34788,2000,40.83,59.17
35,other,3677,1757,1920,2000,47.78,52.22
36,all fields,1244171,531840,712331,2001,42.75,57.25
37,agriculture,5859,3808,2051,2001,64.99,35.01
38,agriculture,8494,3971,4523,2001,46.75,53.25
39,architecture,8480,5086,3394,2001,59.98,40.02
40,"area, ethnic, cultural studies",6317,1916,4401,2001,30.33,69.67
41,biological sciences,60553,24549,36004,2001,40.54,59.46
42,business,260921,131943,128978,2001,50.57,49.43
43,communications,58013,21813,36200,2001,37.6,62.4
44,communications technology,1050,651,399,2001,62.0,38.0
45,computer science,41954,30347,11607,2001,72.33,27.67
46,natural resources,9029,5066,3963,2001,56.11,43.89
47,construction,174,159,15,2001,91.38,8.62
48,education,105566,24592,80974,2001,23.3,76.7
49,engineering,58098,46519,11579,2001,80.07,19.93
50,engineering,13922,12343,1579,2001,88.66,11.34
51,english language and literature,51419,16257,35162,2001,31.62,68.38
52,foreign languages,15146,4411,10735,2001,29.12,70.88
53,health professions,73490,11908,61582,2001,16.2,83.8
54,home economics,17353,2019,15334,2001,11.63,88.37
55,law,1958,530,1428,2001,27.07,72.93
56,liberal arts,37962,12567,25395,2001,33.1,66.9
57,library science,52,7,45,2001,13.46,86.54
58,marketing operations marketing and distribution,4441,1693,2748,2001,38.12,61.88
59,mathematics,11674,6107,5567,2001,52.31,47.69
60,multi/interdisciplinary studies,25999,8434,17565,2001,32.44,67.56
61,parks and recreation,19565,9324,10241,2001,47.66,52.34
62,personal and miscellaneous services,384,220,164,2001,57.29,42.71
63,philosophy and religious studies,8560,5318,3242,2001,62.13,37.87
64,physical sciences,17773,10459,7314,2001,58.85,41.15
65,precision production,347,238,109,2001,68.59,31.41
66,protective services,25211,13772,11439,2001,54.63,45.37
67,psychology,73534,16572,56962,2001,22.54,77.46
68,public administration,19447,3670,15777,2001,18.87,81.13
69,science technology,206,115,91,2001,55.83,44.17
70,social sciences,128036,61749,66287,2001,48.23,51.77
71,theology,6967,4816,2151,2001,69.13,30.87
72,transportation,3748,3312,436,2001,88.37,11.63
73,visual and performing arts,61148,24967,36181,2001,40.83,59.17
74,home economics,424,188,236,2001,44.34,55.66
75,other,897,424,473,2001,47.27,52.73
76,all fields,1291900,549816,742084,2002,42.56,57.44
77,agriculture,5976,3868,2108,2002,64.73,35.27
78,agriculture,8442,3896,4546,2002,46.15,53.85
79,architecture,8808,5224,3584,2002,59.31,40.69
80,"area, ethnic, cultural studies",6557,2042,4515,2002,31.14,68.86
81,biological sciences,60256,23612,36644,2002,39.19,60.81
82,business,276047,138647,137400,2002,50.23,49.77
83,communications,62791,22914,39877,2002,36.49,63.51
84,communications technology,1110,699,411,2002,62.97,37.03
85,computer science,47299,34248,13051,2002,72.41,27.59
86,natural resources,8935,4879,4056,2002,54.61,45.39
87,construction,202,182,20,2002,90.1,9.9
88,education,106383,24051,82332,2002,22.61,77.39
89,engineering,59481,47171,12310,2002,79.3,20.7
90,engineering,14117,12480,1637,2002,88.4,11.6
91,english language and literature,53162,16704,36458,2002,31.42,68.58
92,foreign languages,15318,4413,10905,2002,28.81,71.19
93,health professions,70517,10257,60260,2002,14.55,85.45
94,home economics,17679,1984,15695,2002,11.22,88.78
95,law,1971,588,1383,2002,29.83,70.17
96,liberal arts,39333,12902,26431,2002,32.8,67.2
97,library science,74,18,56,2002,24.32,75.68
98,marketing operations marketing and distribution,4887,1719,3168,2002,35.17,64.83
99,mathematics,12395,6608,5787,2002,53.31,46.69
100,multi/interdisciplinary studies,27629,8948,18681,2002,32.39,67.61
101,parks and recreation,20554,9919,10635,2002,48.26,51.74
102,personal and miscellaneous services,396,200,196,2002,50.51,49.49
103,philosophy and religious studies,9306,5688,3618,2002,61.12,38.88
104,physical sciences,17650,10195,7455,2002,57.76,42.24
105,precision production,468,324,144,2002,69.23,30.77
106,protective services,25536,13727,11809,2002,53.76,46.24
107,psychology,76671,17275,59396,2002,22.53,77.47
108,public administration,19392,3706,15686,2002,19.11,80.89
109,science technology,201,119,82,2002,59.2,40.8
110,social sciences,132874,64170,68704,2002,48.29,51.71
111,theology,7785,5293,2492,2002,67.99,32.01
112,transportation,4020,3555,465,2002,88.43,11.57
113,visual and performing arts,66773,27130,39643,2002,40.63,59.37
114,home economics,474,198,276,2002,41.77,58.23
115,other,431,263,168,2002,61.02,38.98
116,all fields,1348503,573079,775424,2003,42.5,57.5
117,agriculture,14259,7516,6743,2003,52.71,47.29
118,architecture,9054,5329,3725,2003,58.86,41.14
119,"area, ethnic, cultural and gender studies",6629,2056,4573,2003,31.02,68.98
120,biological sciences,60072,22899,37173,2003,38.12,61.88
121,"business, management, marketing and related support services",293022,144887,148135,2003,49.45,50.55
122,"communication, journalism and related programs",67859,24142,43717,2003,35.58,64.42
123,communications technologies technicians and support services,1933,1183,750,2003,61.2,38.8
124,computer science,57439,41950,15489,2003,73.03,26.97
125,construction,166,148,18,2003,89.16,10.84
126,education,105790,22602,83188,2003,21.36,78.64
127,engineering,62611,49945,12666,2003,79.77,20.23
128,engineering technology,14356,12622,1734,2003,87.92,12.08
129,english language and literature,53670,16725,36945,2003,31.16,68.84
130,family and consumer sciences,18166,2212,15954,2003,12.18,87.82
131,"foreign languages, literatures and linguistics",16901,4996,11905,2003,29.56,70.44
132,health professions,71223,10091,61132,2003,14.17,85.83
133,history,27730,16235,11495,2003,58.55,41.45
134,law,2466,715,1751,2003,28.99,71.01
135,"liberal arts and sciences, general studies and humanities",40221,12560,27661,2003,31.23,68.77
136,library science,99,26,73,2003,26.26,73.74
137,mathematics,12493,6776,5717,2003,54.24,45.76
138,mechanic and repair,134,122,12,2003,91.04,8.96
139,military technology,6,6,0,2003,100.0,0.0
140,multi/interdisciplinary studies,28757,9371,19386,2003,32.59,67.41
141,natural resources,9035,4811,4224,2003,53.25,46.75
142,parks and recreation,21428,10736,10692,2003,50.1,49.9
143,personal services,523,264,259,2003,50.48,49.52
144,philosophy and religious studies,10344,6353,3991,2003,61.42,38.58
145,physical sciences,17714,10408,7306,2003,58.76,41.24
146,precision production,42,30,12,2003,71.43,28.57
147,psychology,78613,17504,61109,2003,22.27,77.73
148,public administration,19878,3724,16154,2003,18.73,81.27
149,military,0,0,0,2003,,
150,medical residency,0,0,0,2003,,
151,science technology,226,148,78,2003,65.49,34.51
152,protective services,26189,13402,12787,2003,51.17,48.83
153,social sciences,115488,53263,62225,2003,46.12,53.88
154,technology education,0,0,0,2003,,
155,theology,7926,5322,2604,2003,67.15,32.85
156,transportation and materials moving,4567,4084,483,2003,89.42,10.58
157,visual and performing arts,71474,27916,43558,2003,39.06,60.94
158,all fields,1399542,595425,804117,2004,42.54,57.46
159,"agriculture, agriculture operations,and related sciences",14038,7241,6797,2004,51.58,48.42
160,architecture,8838,5059,3779,2004,57.24,42.76
161,"area, ethnic, cultural and gender studies",7181,2162,5019,2004,30.11,69.89
162,biological sciences,61509,23248,38261,2004,37.8,62.2
163,"business, management, marketing and related support services",306623,152262,154361,2004,49.66,50.34
164,"communication, journalism and related programs",70968,24591,46377,2004,34.65,65.35
165,communications technologies technicians and support services,2034,1222,812,2004,60.08,39.92
166,computer science,59488,44585,14903,2004,74.95,25.05
167,construction,119,107,12,2004,89.92,10.08
168,education,106278,22802,83476,2004,21.46,78.54
169,engineering,63558,50557,13001,2004,79.54,20.46
170,engineering technology,14391,12689,1702,2004,88.17,11.83
171,english language and literature,53984,16792,37192,2004,31.11,68.89
172,family and consumer sciences,19172,2298,16874,2004,11.99,88.01
173,"foreign languages, literatures and linguistics",17754,5215,12539,2004,29.37,70.63
174,health professions,73934,10017,63917,2004,13.55,86.45
175,history,29808,17403,12405,2004,58.38,41.62
176,law,2841,896,1945,2004,31.54,68.46
177,"liberal arts and sciences, general studies and humanities",42106,13336,28770,2004,31.67,68.33
178,library science,72,4,68,2004,5.56,94.44
179,mathematics,13327,7203,6124,2004,54.05,45.95
180,mechanic and repair,159,149,10,2004,93.71,6.29
181,military technology,10,9,1,2004,90.0,10.0
182,multi/interdisciplinary studies,29162,9537,19625,2004,32.7,67.3
183,natural resources,8797,4648,4149,2004,52.84,47.16
184,parks and recreation,22164,11289,10875,2004,50.93,49.07
185,personal services,526,251,275,2004,47.72,52.28
186,philosophy and religious studies,11152,7046,4106,2004,63.18,36.82
187,physical sciences,17795,10377,7418,2004,58.31,41.69
188,precision production,61,38,23,2004,62.3,37.7
189,psychology,82098,18193,63905,2004,22.16,77.84
190,public administration,20552,3793,16759,2004,18.46,81.54
191,science technology,188,99,89,2004,52.66,47.34
192,protective services,28175,14195,13980,2004,50.38,49.62
193,social sciences,120549,56431,64118,2004,46.81,53.19
194,theology,8126,5381,2745,2004,66.22,33.78
195,transportation and materials moving,4824,4263,561,2004,88.37,11.63
196,visual and performing arts,77181,30037,47144,2004,38.92,61.08
197,all fields,1439264,613000,826264,2005,42.59,57.41
198,agriculture,14453,7366,7087,2005,50.97,49.03
199,architecture,9237,5222,4015,2005,56.53,43.47
200,"area, ethnic, cultural and gender studies",7569,2307,5262,2005,30.48,69.52
201,biological sciences,64611,24617,39994,2005,38.1,61.9
202,"business, management, marketing and related support services",310987,155637,155350,2005,50.05,49.95
203,"communication, journalism and related programs",72715,25324,47391,2005,34.83,65.17
204,communications technologies technicians and support services,2523,1602,921,2005,63.5,36.5
205,computer science,54111,42125,11986,2005,77.85,22.15
206,construction,117,107,10,2005,91.45,8.55
207,education,105451,22513,82938,2005,21.35,78.65
208,engineering,64906,52020,12886,2005,80.15,19.85
209,engineering technology,14482,12812,1670,2005,88.47,11.53
210,english language and literature,54379,17154,37225,2005,31.55,68.45
211,family and consumer sciences,20074,2435,17639,2005,12.13,87.87
212,"foreign languages, literatures and linguistics",18386,5370,13016,2005,29.21,70.79
213,health professions,80685,10858,69827,2005,13.46,86.54
214,history,31398,18477,12921,2005,58.85,41.15
215,law,3161,918,2243,2005,29.04,70.96
216,"liberal arts and sciences, general studies and humanities",43751,13732,30019,2005,31.39,68.61
217,library science,76,15,61,2005,19.74,80.26
218,mathematics,14351,7937,6414,2005,55.31,44.69
219,mechanic and repair,238,225,13,2005,94.54,5.46
220,military technology,40,33,7,2005,82.5,17.5
221,multi/interdisciplinary studies,30243,9645,20598,2005,31.89,68.11
222,natural resources,8549,4621,3928,2005,54.05,45.95
223,parks and recreation,22888,11702,11186,2005,51.13,48.87
224,personal services,587,303,284,2005,51.62,48.38
225,philosophy and religious studies,11584,7225,4359,2005,62.37,37.63
226,physical sciences,18677,10790,7887,2005,57.77,42.23
227,precision production,64,45,19,2005,70.31,29.69
228,psychology,85614,19000,66614,2005,22.19,77.81
229,public administration,21769,4209,17560,2005,19.33,80.67
230,science technology,228,144,84,2005,63.16,36.84
231,protective services,30723,15354,15369,2005,49.98,50.02
232,social sciences,125494,59225,66269,2005,47.19,52.81
233,theology,9284,6253,3031,2005,67.35,32.65
234,transportation and materials moving,4904,4323,581,2005,88.15,11.85
235,visual and performing arts,80955,31355,49600,2005,38.73,61.27
236,all fields,1485242,630600,854642,2006,42.46,57.54
237,agriculture,14291,7318,6973,2006,51.21,48.79
238,architecture,9515,5414,4101,2006,56.9,43.1
239,"area, ethnic, cultural and gender studies",7879,2420,5459,2006,30.71,69.29
240,biological sciences,69178,26651,42527,2006,38.53,61.47
241,"business, management, marketing and related support services",317391,159366,158025,2006,50.21,49.79
242,"communication, journalism and related programs",73955,26135,47820,2006,35.34,64.66
243,communications technologies technicians and support services,2981,2007,974,2006,67.33,32.67
244,computer science,47480,37705,9775,2006,79.41,20.59
245,construction,141,134,7,2006,95.04,4.96
246,education,107238,22448,84790,2006,20.93,79.07
247,engineering,67045,54036,13009,2006,80.6,19.4
248,engineering technology,14178,12604,1574,2006,88.9,11.1
249,english language and literature,55096,17316,37780,2006,31.43,68.57
250,family and consumer sciences,20775,2436,18339,2006,11.73,88.27
251,"foreign languages, literatures and linguistics",19410,5842,13568,2006,30.1,69.9
252,health professions,91973,12914,79059,2006,14.04,85.96
253,history,33153,19434,13719,2006,58.62,41.38
254,law,3302,982,2320,2006,29.74,70.26
255,"liberal arts and sciences, general studies and humanities",44898,14144,30754,2006,31.5,68.5
256,library science,76,5,71,2006,6.58,93.42
257,mathematics,14770,8115,6655,2006,54.94,45.06
258,mechanic and repair,246,239,7,2006,97.15,2.85
259,military technology,33,29,4,2006,87.88,12.12
260,multi/interdisciplinary studies,32012,9959,22053,2006,31.11,68.89
261,natural resources,8762,4745,4017,2006,54.15,45.85
262,parks and recreation,25490,13310,12180,2006,52.22,47.78
263,personal services,651,317,334,2006,48.69,51.31
264,philosophy and religious studies,11985,7428,4557,2006,61.98,38.02
265,physical sciences,20048,11681,8367,2006,58.27,41.73
266,precision production,55,35,20,2006,63.64,36.36
267,psychology,88134,19865,68269,2006,22.54,77.46
268,public administration,21986,4126,17860,2006,18.77,81.23
269,science technology,270,150,120,2006,55.56,44.44
270,protective services,35319,17498,17821,2006,49.54,50.46
271,social sciences,128332,61365,66967,2006,47.82,52.18
272,theology,8548,5593,2955,2006,65.43,34.57
273,transportation and materials moving,5349,4717,632,2006,88.18,11.82
274,visual and performing arts,83297,32117,51180,2006,38.56,61.44
275,all fields,1524092,649570,874522,2007,42.62,57.38
276,agriculture,14473,7539,6934,2007,52.09,47.91
277,architecture,9717,5393,4324,2007,55.5,44.5
278,"area, ethnic, cultural and gender studies",8194,2572,5622,2007,31.39,68.61
279,biological sciences,75151,29951,45200,2007,39.85,60.15
280,"business, management, marketing and related support services",326795,166000,160795,2007,50.8,49.2
281,"communication, journalism and related programs",74783,26444,48339,2007,35.36,64.64
282,communications technologies technicians and support services,3637,2565,1072,2007,70.53,29.47
283,computer science,42170,34342,7828,2007,81.44,18.56
284,construction,129,122,7,2007,94.57,5.43
285,education,105641,22516,83125,2007,21.31,78.69
286,engineering,67092,54745,12347,2007,81.6,18.4
287,engineering technology,14588,13114,1474,2007,89.9,10.1
288,english language and literature,55122,17475,37647,2007,31.7,68.3
289,family and consumer sciences,21400,2594,18806,2007,12.12,87.88
290,"foreign languages, literatures and linguistics",20275,6173,14102,2007,30.45,69.55
291,health professions,101810,14325,87485,2007,14.07,85.93
292,history,34446,20217,14229,2007,58.69,41.31
293,law,3596,1008,2588,2007,28.03,71.97
294,"liberal arts and sciences, general studies and humanities",44255,14123,30132,2007,31.91,68.09
295,library science,82,10,72,2007,12.2,87.8
296,mathematics,14954,8360,6594,2007,55.9,44.1
297,mechanic and repair,263,249,14,2007,94.68,5.32
298,military technology,168,152,16,2007,90.48,9.52
299,multi/interdisciplinary studies,33792,10439,23353,2007,30.89,69.11
300,natural resources,8660,4770,3890,2007,55.08,44.92
301,parks and recreation,27430,14190,13240,2007,51.73,48.27
302,personal services,736,350,386,2007,47.55,52.45
303,philosophy and religious studies,11969,7430,4539,2007,62.08,37.92
304,physical sciences,20783,12295,8488,2007,59.16,40.84
305,precision production,23,12,11,2007,52.17,47.83
306,psychology,90039,20343,69696,2007,22.59,77.41
307,public administration,23147,4354,18793,2007,18.81,81.19
308,science technology,290,160,130,2007,55.17,44.83
309,protective services,39206,19505,19701,2007,49.75,50.25
310,social sciences,129737,62200,67537,2007,47.94,52.06
311,theology,8696,5761,2935,2007,66.25,33.75
312,transportation and materials moving,5657,5043,614,2007,89.15,10.85
313,visual and performing arts,85186,32729,52457,2007,38.42,61.58
314,all fields,1563075,667930,895145,2008,42.73,57.27
315,agriculture,14726,7530,7196,2008,51.13,48.87
316,architecture,9805,5579,4226,2008,56.9,43.1
317,"area, ethnic, cultural and gender studies",8454,2641,5813,2008,31.24,68.76
318,biological sciences,77854,31637,46217,2008,40.64,59.36
319,"business, management, marketing and related support services",334300,170539,163761,2008,51.01,48.99
320,"communication, journalism and related programs",76382,27043,49339,2008,35.4,64.6
321,communications technologies technicians and support services,4666,3341,1325,2008,71.6,28.4
322,computer science,38476,31694,6782,2008,82.37,17.63
323,construction,180,172,8,2008,95.56,4.44
324,education,102582,21828,80754,2008,21.28,78.72
325,engineering,68676,56067,12609,2008,81.64,18.36
326,engineering technology,14765,13266,1499,2008,89.85,10.15
327,english language and literature,55038,17681,37357,2008,32.13,67.87
328,family and consumer sciences,21870,2659,19211,2008,12.16,87.84
329,"foreign languages, literatures and linguistics",20977,6254,14723,2008,29.81,70.19
330,health professions,111484,16288,95196,2008,14.61,85.39
331,history,34441,20356,14085,2008,59.1,40.9
332,law,3771,1089,2682,2008,28.88,71.12
333,"liberal arts and sciences, general studies and humanities",46940,15876,31064,2008,33.82,66.18
334,library science,68,6,62,2008,8.82,91.18
335,mathematics,15192,8490,6702,2008,55.88,44.12
336,mechanic and repair,232,219,13,2008,94.4,5.6
337,military technology,39,35,4,2008,89.74,10.26
338,multi/interdisciplinary studies,36149,11279,24870,2008,31.2,68.8
339,natural resources,9387,5104,4283,2008,54.37,45.63
340,parks and recreation,29931,15615,14316,2008,52.17,47.83
341,personal services,954,439,515,2008,46.02,53.98
342,philosophy and religious studies,12257,7696,4561,2008,62.79,37.21
343,physical sciences,21669,12824,8845,2008,59.18,40.82
344,precision production,33,22,11,2008,66.67,33.33
345,psychology,92587,21202,71385,2008,22.9,77.1
346,public administration,23493,4202,19291,2008,17.89,82.11
347,science technology,265,135,130,2008,50.94,49.06
348,protective services,40235,20149,20086,2008,50.08,49.92
349,social sciences,132922,64512,68410,2008,48.53,51.47
350,theology,8992,5873,3119,2008,65.31,34.69
351,transportation and materials moving,5203,4604,599,2008,88.49,11.51
352,visual and performing arts,87703,33862,53841,2008,38.61,61.39
353,other,377,122,255,2008,32.36,67.64
354,all fields,1601368,685382,915986,2009,42.8,57.2
355,agriculture,15160,7677,7483,2009,50.64,49.36
356,architecture,10119,5797,4322,2009,57.29,42.71
357,"area, ethnic, cultural and gender studies",8772,2735,6037,2009,31.18,68.82
358,biological sciences,80756,32925,47831,2009,40.77,59.23
359,"business, management, marketing and related support services",346972,177381,169591,2009,51.12,48.88
360,"communication, journalism and related programs",78009,27519,50490,2009,35.28,64.72
361,communications technologies technicians and support services,5100,3699,1401,2009,72.53,27.47
362,computer science,37994,31215,6779,2009,82.16,17.84
363,construction,168,163,5,2009,97.02,2.98
364,education,101708,21159,80549,2009,20.8,79.2
365,engineering,69133,56716,12417,2009,82.04,17.96
366,engineering technology,15112,13589,1523,2009,89.92,10.08
367,english language and literature,55462,17973,37489,2009,32.41,67.59
368,family and consumer sciences,21905,2754,19151,2009,12.57,87.43
369,"foreign languages, literatures and linguistics",21158,6302,14856,2009,29.79,70.21
370,health professions,120488,17792,102696,2009,14.77,85.23
371,history,34711,20440,14271,2009,58.89,41.11
372,law,3822,1037,2785,2009,27.13,72.87
373,"liberal arts and sciences, general studies and humanities",47096,16616,30480,2009,35.28,64.72
374,library science,78,8,70,2009,10.26,89.74
375,mathematics,15496,8793,6703,2009,56.74,43.26
376,mechanic and repair,223,207,16,2009,92.83,7.17
377,military technology,55,54,1,2009,98.18,1.82
378,multi/interdisciplinary studies,37444,11857,25587,2009,31.67,68.33
379,natural resources,9828,5424,4404,2009,55.19,44.81
380,parks and recreation,31667,16666,15001,2009,52.63,47.37
381,personal services,1013,481,532,2009,47.48,52.52
382,philosophy and religious studies,12444,7761,4683,2009,62.37,37.63
383,physical sciences,22153,13151,9002,2009,59.36,40.64
384,precision production,29,19,10,2009,65.52,34.48
385,psychology,94271,21488,72783,2009,22.79,77.21
386,public administration,23851,4374,19477,2009,18.34,81.66
387,science technology,313,148,165,2009,47.28,52.72
388,protective services,41800,21073,20727,2009,50.41,49.59
389,social sciences,133789,64757,69032,2009,48.4,51.6
390,theology,8940,5950,2990,2009,66.55,33.45
391,transportation and materials moving,5189,4631,558,2009,89.25,10.75
392,visual and performing arts,89140,35051,54089,2009,39.32,60.68
393,all fields,1650014,706633,943381,2010,42.83,57.17
394,agriculture,15374,7706,7668,2010,50.12,49.88
395,architecture,10051,5694,4357,2010,56.65,43.35
396,"area, ethnic, cultural and gender studies",8621,2694,5927,2010,31.25,68.75
397,biological sciences,86400,35865,50535,2010,41.51,58.49
398,"business, management, marketing and related support services",357354,182867,174487,2010,51.17,48.83
399,"communication, journalism and related programs",81266,28595,52671,2010,35.19,64.81
400,communications technologies technicians and support services,4782,3445,1337,2010,72.04,27.96
401,computer science,39589,32410,7179,2010,81.87,18.13
402,construction,273,261,12,2010,95.6,4.4
403,education,101265,20726,80539,2010,20.47,79.53
404,engineering,72654,59360,13294,2010,81.7,18.3
405,engineering technology,15596,14014,1582,2010,89.86,10.14
406,english language and literature,53231,17050,36181,2010,32.03,67.97
407,family and consumer sciences,21818,2686,19132,2010,12.31,87.69
408,"foreign languages, literatures and linguistics",21516,6610,14906,2010,30.72,69.28
409,health professions,129634,19306,110328,2010,14.89,85.11
410,history,35198,20879,14319,2010,59.32,40.68
411,law,3886,1096,2790,2010,28.2,71.8
412,"liberal arts and sciences, general studies and humanities",46953,16619,30334,2010,35.39,64.61
413,library science,85,11,74,2010,12.94,87.06
414,mathematics,16030,9087,6943,2010,56.69,43.31
415,mechanic and repair,206,198,8,2010,96.12,3.88
416,military technology,56,54,2,2010,96.43,3.57
417,multi/interdisciplinary studies,37648,12129,25519,2010,32.22,67.78
418,natural resources,10962,5813,5149,2010,53.03,46.97
419,parks and recreation,33318,17621,15697,2010,52.89,47.11
420,personal services,939,434,505,2010,46.22,53.78
421,philosophy and religious studies,12504,7910,4594,2010,63.26,36.74
422,physical sciences,23041,13697,9344,2010,59.45,40.55
423,precision production,29,19,10,2010,65.52,34.48
424,psychology,97216,22275,74941,2010,22.91,77.09
425,public administration,25414,4578,20836,2010,18.01,81.99
426,science technology,338,165,173,2010,48.82,51.18
427,protective services,43667,22265,21402,2010,50.99,49.01
428,social sciences,137582,66527,71055,2010,48.35,51.65
429,theology,8718,5756,2962,2010,66.02,33.98
430,transportation and materials moving,4998,4443,555,2010,88.9,11.1
431,visual and performing arts,91802,35768,56034,2010,38.96,61.04
432,all fields,1716053,734159,981894,2011,42.78,57.22
433,agriculture,15851,7821,8030,2011,49.34,50.66
434,architecture,9831,5698,4133,2011,57.96,42.04
435,"area, ethnic, cultural, gender and group studies",8955,2759,6196,2011,30.81,69.19
436,biological sciences,89984,36888,53096,2011,40.99,59.01
437,"business, management, marketing and related support services",363919,186538,177381,2011,51.26,48.74
438,"communication, journalism and related programs",83231,29510,53721,2011,35.46,64.54
439,communications technologies technicians and support services,4858,3508,1350,2011,72.21,27.79
440,computer science,43066,35477,7589,2011,82.38,17.62
441,construction,328,303,25,2011,92.38,7.62
442,education,104008,21206,82802,2011,20.39,79.61
443,engineering,76356,62099,14257,2011,81.33,18.67
444,engineering technology,16187,14469,1718,2011,89.39,10.61
445,english language and literature,52754,16917,35837,2011,32.07,67.93
446,family and consumer sciences,22438,2761,19677,2011,12.31,87.69
447,"foreign languages, literatures and linguistics",21705,6719,14986,2011,30.96,69.04
448,health professions,143463,21540,121923,2011,15.01,84.99
449,history,35008,20827,14181,2011,59.49,40.51
450,law,4429,1317,3112,2011,29.74,70.26
451,"liberal arts and sciences, general studies and humanities",46717,16478,30239,2011,35.27,64.73
452,library science,96,13,83,2011,13.54,86.46
453,mathematics,17182,9782,7400,2011,56.93,43.07
454,mechanic and repair,226,209,17,2011,92.48,7.52
455,military technology,64,50,14,2011,78.12,21.88
456,multi/interdisciplinary studies,42473,13661,28812,2011,32.16,67.84
457,natural resources,12779,6857,5922,2011,53.66,46.34
458,parks and recreation,35934,18937,16997,2011,52.7,47.3
459,personal services,1214,578,636,2011,47.61,52.39
460,philosophy and religious studies,12830,8147,4683,2011,63.5,36.5
461,physical sciences,24338,14596,9742,2011,59.97,40.03
462,precision production,43,22,21,2011,51.16,48.84
463,psychology,100906,23230,77676,2011,23.02,76.98
464,public administration,26799,4913,21886,2011,18.33,81.67
465,science technology,367,182,185,2011,49.59,50.41
466,protective services,47600,24361,23239,2011,51.18,48.82
467,social sciences,142161,68982,73179,2011,48.52,51.48
468,theology,9073,6117,2956,2011,67.42,32.58
469,transportation and materials moving,4941,4345,596,2011,87.94,12.06
470,visual and performing arts,93939,36342,57597,2011,38.69,61.31
471,all fields,1792163,765772,1026391,2012,42.73,57.27
472,agriculture,16252,7867,8385,2012,48.41,51.59
473,architecture,9727,5566,4161,2012,57.22,42.78
474,"area, ethnic, cultural, gender and group studies",9228,2757,6471,2012,29.88,70.12
475,biological sciences,95850,39542,56308,2012,41.25,58.75
476,"business, management, marketing and related support services",365910,189584,176326,2012,51.81,48.19
477,"communication, journalism and related programs",83771,29921,53850,2012,35.72,64.28
478,communications technologies technicians and support services,4983,3604,1379,2012,72.33,27.67
479,computer science,47406,38796,8610,2012,81.84,18.16
480,construction,377,359,18,2012,95.23,4.77
481,education,105656,21714,83942,2012,20.55,79.45
482,engineering,81371,65819,15552,2012,80.89,19.11
483,engineering,16656,14951,1705,2012,89.76,10.24
484,english language and literature,53765,16976,36789,2012,31.57,68.43
485,family and consumer sciences,23441,2693,20748,2012,11.49,88.51
486,"foreign languages, literatures and linguistics",21756,6629,15127,2012,30.47,69.53
487,health professions and related programs,163675,24905,138770,2012,15.22,84.78
488,history,35122,20971,14151,2012,59.71,40.29
489,civil service,54091,27957,26134,2012,51.69,48.31
490,law,4595,1389,3206,2012,30.23,69.77
491,"liberal arts and sciences, general studies and humanities",46961,16953,30008,2012,36.1,63.9
492,library science,95,7,88,2012,7.37,92.63
493,mathematics,18841,10722,8119,2012,56.91,43.09
494,mechanic and repair,250,235,15,2012,94.0,6.0
495,military technologies and applied sciences,86,69,17,2012,80.23,19.77
496,multi/interdisciplinary studies,45717,14597,31120,2012,31.93,68.07
497,natural resources,14720,7618,7102,2012,51.75,48.25
498,parks and recreation,38998,20834,18164,2012,53.42,46.58
499,personal services,1325,596,729,2012,44.98,55.02
500,philosophy and religious studies,12645,7958,4687,2012,62.93,37.07
501,physical sciences,26104,15664,10440,2012,60.01,39.99
502,precision production,37,28,9,2012,75.68,24.32
503,psychology,109099,25420,83679,2012,23.3,76.7
504,public administration,29695,5386,24309,2012,18.14,81.86
505,science technology,560,308,252,2012,55.0,45.0
506,social sciences,143412,69657,73755,2012,48.57,51.43
507,theology,9304,6251,3053,2012,67.19,32.81
508,transportation and materials moving,4876,4305,571,2012,88.29,11.71
509,visual and performing arts,95806,37164,58642,2012,38.79,61.21
510,all fields,1840381,787408,1052973,2013,42.79,57.21
511,agriculture,17083,8144,8939,2013,47.67,52.33
512,architecture,9757,5581,4176,2013,57.2,42.8
513,"area, ethnic, cultural, gender and group studies",8850,2623,6227,2013,29.64,70.36
514,biological sciences,100397,41556,58841,2013,41.39,58.61
515,"business, management, marketing and related support services",359585,187253,172332,2013,52.07,47.93
516,"communication, journalism and related programs",84818,30148,54670,2013,35.54,64.46
517,communications technologies technicians and support services,4987,3522,1465,2013,70.62,29.38
518,computer science,50961,41874,9087,2013,82.17,17.83
519,construction,244,225,19,2013,92.21,7.79
520,education,104698,21824,82874,2013,20.84,79.16
521,engineering,85987,69430,16557,2013,80.74,19.26
522,engineering,16493,14742,1751,2013,89.38,10.62
523,english language and literature,52401,16508,35893,2013,31.5,68.5
524,family and consumer sciences,23930,2872,21058,2013,12.0,88.0
525,"foreign languages, literatures and linguistics",21647,6842,14805,2013,31.61,68.39
526,health professions and related programs,181149,28208,152941,2013,15.57,84.43
527,history,34188,20461,13727,2013,59.85,40.15
528,civil service,60264,31795,28469,2013,52.76,47.24
529,law,4425,1308,3117,2013,29.56,70.44
530,"liberal arts and sciences, general studies and humanities",46790,16991,29799,2013,36.31,63.69
531,library science,102,12,90,2013,11.76,88.24
532,mathematics,20449,11599,8850,2013,56.72,43.28
533,mechanic and repair,273,248,25,2013,90.84,9.16
534,military technologies and applied sciences,105,80,25,2013,76.19,23.81
535,multi/interdisciplinary studies,47658,15332,32326,2013,32.17,67.83
536,natural resources,16509,8474,8035,2013,51.33,48.67
537,parks and recreation,42628,23170,19458,2013,54.35,45.65
538,personal services,1302,590,712,2013,45.31,54.69
539,philosophy and religious studies,12792,8149,4643,2013,63.7,36.3
540,physical sciences,27471,16828,10643,2013,61.26,38.74
541,precision production,36,23,13,2013,63.89,36.11
542,psychology,114446,26814,87632,2013,23.43,76.57
543,public administration,31950,5664,26286,2013,17.73,82.27
544,science technology,582,314,268,2013,53.95,46.05
545,social sciences,143579,69682,73897,2013,48.53,51.47
546,theology,9385,6351,3034,2013,67.67,32.33
547,transportation and materials moving,4661,4108,553,2013,88.14,11.86
548,visual and performing arts,97799,38063,59736,2013,38.92,61.08
549,all fields,1870150,801905,1068245,2014,42.88,57.12
550,agriculture,18036,8437,9599,2014,46.78,53.22
551,architecture,9149,5174,3975,2014,56.55,43.45
552,"area, ethnic, cultural, gender and group studies",8275,2466,5809,2014,29.8,70.2
553,biological sciences,104657,43440,61217,2014,41.51,58.49
554,"business, management, marketing and related support services",356800,187868,168932,2014,52.65,47.35
555,"communication, journalism and related programs",87612,30974,56638,2014,35.35,64.65
556,communications technologies technicians and support services,4991,3419,1572,2014,68.5,31.5
557,computer science,55271,45320,9951,2014,82.0,18.0
558,construction,268,243,25,2014,90.67,9.33
559,education,98838,20357,78481,2014,20.6,79.4
560,engineering,92169,73906,18263,2014,80.19,19.81
561,engineering,16221,14495,1726,2014,89.36,10.64
562,english language and literature,50464,15831,34633,2014,31.37,68.63
563,family and consumer sciences,24689,3009,21680,2014,12.19,87.81
564,"foreign languages, literatures and linguistics",20332,6266,14066,2014,30.82,69.18
565,health professions and related programs,198777,30932,167845,2014,15.56,84.44
566,history,31122,18763,12359,2014,60.29,39.71
567,civil service,62416,33407,29009,2014,53.52,46.48
568,law,4513,1456,3057,2014,32.26,67.74
569,"liberal arts and sciences, general studies and humanities",45281,16495,28786,2014,36.43,63.57
570,library science,127,14,113,2014,11.02,88.98
571,mathematics,20987,11970,9017,2014,57.04,42.96
572,mechanic and repair,318,297,21,2014,93.4,6.6
573,military technologies and applied sciences,185,161,24,2014,87.03,12.97
574,multi/interdisciplinary studies,48392,16126,32266,2014,33.32,66.68
575,natural resources,17089,8817,8272,2014,51.59,48.41
576,parks and recreation,46047,24717,21330,2014,53.68,46.32
577,personal services,1332,600,732,2014,45.05,54.95
578,philosophy and religious studies,11999,7583,4416,2014,63.2,36.8
579,physical sciences,28811,17535,11276,2014,60.86,39.14
580,precision production,37,21,16,2014,56.76,43.24
581,psychology,117312,27306,90006,2014,23.28,76.72
582,public administration,33483,5916,27567,2014,17.67,82.33
583,science technology,496,269,227,2014,54.23,45.77
584,social sciences,142010,69491,72519,2014,48.93,51.07
585,theology,9642,6594,3048,2014,68.39,31.61
586,transportation and materials moving,4588,4053,535,2014,88.34,11.66
587,visual and performing arts,97414,38177,59237,2014,39.19,60.81
588,all fields,1894969,812693,1082276,2015,42.89,57.11
589,agriculture,19120,8954,10166,2015,46.83,53.17
590,natural resources,17158,8631,8527,2015,50.3,49.7
591,architecture,9090,5116,3974,2015,56.28,43.72
592,"area, ethnic, cultural, gender and group studies",7783,2294,5489,2015,29.47,70.53
593,"communication, journalism and related programs",90658,31853,58805,2015,35.14,64.86
594,communications technologies technicians and support services,5135,3367,1768,2015,65.57,34.43
595,computer science,59586,48844,10742,2015,81.97,18.03
596,personal services,1402,637,765,2015,45.44,54.56
597,education,91596,18467,73129,2015,20.16,79.84
598,engineering,97852,78249,19603,2015,79.97,20.03
599,engineering,16611,14693,1918,2015,88.45,11.55
600,"foreign languages, literatures and linguistics",19493,6066,13427,2015,31.12,68.88
601,family and consumer sciences,24584,3012,21572,2015,12.25,87.75
602,law,4420,1348,3072,2015,30.5,69.5
603,english language and literature,45851,14055,31796,2015,30.65,69.35
604,"liberal arts and sciences, general studies and humanities",43649,16136,27513,2015,36.97,63.03
605,library science,99,16,83,2015,16.16,83.84
606,biological sciences,109904,45104,64800,2015,41.04,58.96
607,mathematics,21854,12462,9392,2015,57.02,42.98
608,military technologies and applied sciences,276,225,51,2015,81.52,18.48
609,multi/interdisciplinary studies,47556,15930,31626,2015,33.5,66.5
610,parks and recreation,49008,25950,23058,2015,52.95,47.05
611,philosophy and religious studies,11071,7004,4067,2015,63.26,36.74
612,theology,9713,6616,3097,2015,68.11,31.89
613,physical sciences,29541,18187,11354,2015,61.57,38.43
614,science technology,501,293,208,2015,58.48,41.52
615,psychology,117573,26803,90770,2015,22.8,77.2
616,"homeland security, law enforcement, firefighting and related protective service",62723,33640,29083,2015,53.63,46.37
617,public administration,34364,6146,28218,2015,17.88,82.12
618,social sciences,138933,68698,70235,2015,49.45,50.55
619,construction,247,229,18,2015,92.71,7.29
620,mechanic and repair,395,370,25,2015,93.67,6.33
621,precision production,48,33,15,2015,68.75,31.25
622,transportation and materials moving,4730,4146,584,2015,87.65,12.35
623,visual and performing arts,95840,38024,57816,2015,39.67,60.33
624,health professions and related programs,216228,33658,182570,2015,15.57,84.43
625,"business, management, marketing and related support services",362339,190651,171688,2015,52.62,47.38
626,history,28038,16786,11252,2015,59.87,40.13
627,all fields,1920750,821746,1099004,2016,42.78,57.22
628,agriculture,19449,8853,10596,2016,45.52,54.48
629,natural resources,17546,8764,8782,2016,49.95,50.05
630,architecture,8825,4853,3972,2016,54.99,45.01
631,"area, ethnic, cultural, gender and group studies",7840,2225,5615,2016,28.38,71.62
632,"communication, journalism and related programs",92551,32441,60110,2016,35.05,64.95
633,communications technologies technicians and support services,4824,3099,1725,2016,64.24,35.76
634,computer science,64402,52330,12072,2016,81.26,18.74
635,personal services,1386,580,806,2016,41.85,58.15
636,education,87221,17429,69792,2016,19.98,80.02
637,engineering,106789,84456,22333,2016,79.09,20.91
638,engineering,16548,14545,2003,2016,87.9,12.1
639,"foreign languages, literatures and linguistics",18436,5755,12681,2016,31.22,68.78
640,family and consumer sciences,25389,2982,22407,2016,11.75,88.25
641,law,4243,1296,2947,2016,30.54,69.46
642,english language and literature,42797,12777,30020,2016,29.85,70.15
643,"liberal arts and sciences, general studies and humanities",43669,16150,27519,2016,36.98,63.02
644,library science,85,6,79,2016,7.06,92.94
645,biological sciences,113794,45613,68181,2016,40.08,59.92
646,mathematics,22778,13090,9688,2016,57.47,42.53
647,military technologies and applied sciences,358,290,68,2016,81.01,18.99
648,multi/interdisciplinary studies,48833,16244,32589,2016,33.26,66.74
649,parks and recreation,50912,26708,24204,2016,52.46,47.54
650,philosophy and religious studies,10155,6371,3784,2016,62.74,37.26
651,theology,9804,6749,3055,2016,68.84,31.16
652,physical sciences,30002,18394,11608,2016,61.31,38.69
653,science technology,481,277,204,2016,57.59,42.41
654,psychology,117447,26277,91170,2016,22.37,77.63
655,"homeland security, law enforcement, firefighting and related protective service",61159,32600,28559,2016,53.3,46.7
656,public administration,34433,6023,28410,2016,17.49,82.51
657,social sciences,135622,66006,69616,2016,48.67,51.33
658,construction,225,208,17,2016,92.44,7.56
659,mechanic and repair,386,359,27,2016,93.01,6.99
660,precision production,51,28,23,2016,54.9,45.1
661,transportation and materials moving,4531,3979,552,2016,87.82,12.18
662,visual and performing arts,92979,36712,56267,2016,39.48,60.52
663,health professions and related programs,228907,36262,192645,2016,15.84,84.16
664,"business, management, marketing and related support services",370304,195729,174575,2016,52.86,47.14
665,history,25589,15286,10303,2016,59.74,40.26
666,all fields,1956114,836021,1120093,2017,42.74,57.26
667,agriculture,19678,8727,10951,2017,44.35,55.65
668,natural resources,18056,9096,8960,2017,50.38,49.62
669,architecture,8579,4588,3991,2017,53.48,46.52
670,"area, ethnic, cultural, gender and group studies",7720,2112,5608,2017,27.36,72.64
671,"communication, journalism and related programs",93794,32480,61314,2017,34.63,65.37
672,communications technologies technicians and support services,4615,2879,1736,2017,62.38,37.62
673,computer science,71416,57763,13653,2017,80.88,19.12
674,personal services,1154,442,712,2017,38.3,61.7
675,education,85130,16067,69063,2017,18.87,81.13
676,engineering,115671,90758,24913,2017,78.46,21.54
677,engineering,17667,15385,2282,2017,87.08,12.92
678,"foreign languages, literatures and linguistics",17643,5560,12083,2017,31.51,68.49
679,family and consumer sciences,25080,3024,22056,2017,12.06,87.94
680,law,4272,1355,2917,2017,31.72,68.28
681,english language and literature,41314,12243,29071,2017,29.63,70.37
682,"liberal arts and sciences, general studies and humanities",44103,16117,27986,2017,36.54,63.46
683,library science,99,11,88,2017,11.11,88.89
684,biological sciences,116768,45514,71254,2017,38.98,61.02
685,mathematics,24075,14003,10072,2017,58.16,41.84
686,military technologies and applied sciences,469,401,68,2017,85.5,14.5
687,multi/interdisciplinary studies,49631,16796,32835,2017,33.84,66.16
688,parks and recreation,53292,27402,25890,2017,51.42,48.58
689,philosophy and religious studies,9711,6010,3701,2017,61.89,38.11
690,theology,9518,6632,2886,2017,69.68,30.32
691,physical sciences,30724,18568,12156,2017,60.43,39.57
692,science technology,548,295,253,2017,53.83,46.17
693,psychology,116859,25520,91339,2017,21.84,78.16
694,"homeland security, law enforcement, firefighting and related protective service",59553,31570,27983,2017,53.01,46.99
695,public administration,35461,6238,29223,2017,17.59,82.41
696,social sciences,135043,65261,69782,2017,48.33,51.67
697,construction,153,133,20,2017,86.93,13.07
698,mechanic and repair,299,283,16,2017,94.65,5.35
699,precision production,32,18,14,2017,56.25,43.75
700,transportation and materials moving,4708,4134,574,2017,87.81,12.19
701,visual and performing arts,91291,35304,55987,2017,38.67,61.33
702,health professions and related programs,237979,37746,200233,2017,15.86,84.14
703,"business, management, marketing and related support services",379955,201282,178673,2017,52.98,47.02
704,history,24054,14304,9750,2017,59.47,40.53
705,all fields,1980665,844979,1135686,2018,42.66,57.34
706,agriculture,20216,9003,11213,2018,44.53,55.47
707,natural resources,19101,9201,9900,2018,48.17,51.83
708,architecture,8464,4474,3990,2018,52.86,47.14
709,"area, ethnic, cultural, gender and group studies",7717,2118,5599,2018,27.45,72.55
710,"communication, journalism and related programs",92289,31810,60479,2018,34.47,65.53
711,communications technologies technicians and support services,4231,2376,1855,2018,56.16,43.84
712,computer science,79597,63703,15894,2018,80.03,19.97
713,personal services,801,276,525,2018,34.46,65.54
714,education,82599,15166,67433,2018,18.36,81.64
715,engineering,121953,94845,27108,2018,77.77,22.23
716,engineering,18229,15862,2367,2018,87.02,12.98
717,"foreign languages, literatures and linguistics",16957,5287,11670,2018,31.18,68.82
718,family and consumer sciences,24357,2948,21409,2018,12.1,87.9
719,law,4242,1341,2901,2018,31.61,68.39
720,english language and literature,40002,11680,28322,2018,29.2,70.8
721,"liberal arts and sciences, general studies and humanities",44262,15966,28296,2018,36.07,63.93
722,library science,81,7,74,2018,8.64,91.36
723,biological sciences,118661,44851,73810,2018,37.8,62.2
724,mathematics,25253,14539,10714,2018,57.57,42.43
725,military technologies and applied sciences,655,533,122,2018,81.37,18.63
726,multi/interdisciplinary studies,51982,17605,34377,2018,33.87,66.13
727,parks and recreation,53887,27562,26325,2018,51.15,48.85
728,philosophy and religious studies,9603,5935,3668,2018,61.8,38.2
729,theology,9521,6601,2920,2018,69.33,30.67
730,physical sciences,31003,18628,12375,2018,60.08,39.92
731,science technology,539,310,229,2018,57.51,42.49
732,psychology,116436,24579,91857,2018,21.11,78.89
733,"homeland security, law enforcement, firefighting and related protective service",58121,30482,27639,2018,52.45,47.55
734,public administration,35637,6127,29510,2018,17.19,82.81
735,social sciences,136580,65753,70827,2018,48.14,51.86
736,construction,151,130,21,2018,86.09,13.91
737,mechanic and repair,348,333,15,2018,95.69,4.31
738,precision production,45,19,26,2018,42.22,57.78
739,transportation and materials moving,4924,4282,642,2018,86.96,13.04
740,visual and performing arts,88507,34170,54337,2018,38.61,61.39
741,health professions and related programs,244893,38018,206875,2018,15.52,84.48
742,"business, management, marketing and related support services",385439,204589,180850,2018,53.08,46.92
743,history,23382,13870,9512,2018,59.32,40.68
744,all fields,2013086,857607,1155479,2019,42.6,57.4
745,agriculture,20560,8934,11626,2019,43.45,56.55
746,natural resources,19897,9274,10623,2019,46.61,53.39
747,architecture,8806,4569,4237,2019,51.89,48.11
748,"area, ethnic, cultural, gender and group studies",7733,2065,5668,2019,26.7,73.3
749,"communication, journalism and related programs",92528,32704,59824,2019,35.34,64.66
750,communications technologies technicians and support services,4444,2544,1900,2019,57.25,42.75
751,computer science,88638,70322,18316,2019,79.34,20.66
752,personal services,806,298,508,2019,36.97,63.03
753,education,83952,15070,68882,2019,17.95,82.05
754,engineering,126692,97853,28839,2019,77.24,22.76
755,engineering,19089,16561,2528,2019,86.76,13.24
756,"foreign languages, literatures and linguistics",16605,5121,11484,2019,30.84,69.16
757,family and consumer sciences,23956,2832,21124,2019,11.82,88.18
758,law,4235,1315,2920,2019,31.05,68.95
759,english language and literature,39344,11276,28068,2019,28.66,71.34
760,"liberal arts and sciences, general studies and humanities",44222,15905,28317,2019,35.97,64.03
761,library science,99,12,87,2019,12.12,87.88
762,biological sciences,121233,44642,76591,2019,36.82,63.18
763,mathematics,26155,15044,11111,2019,57.52,42.48
764,military technologies and applied sciences,767,608,159,2019,79.27,20.73
765,multi/interdisciplinary studies,53303,18655,34648,2019,35.0,65.0
766,parks and recreation,53540,26978,26562,2019,50.39,49.61
767,philosophy and religious studies,9624,5805,3819,2019,60.32,39.68
768,theology,9418,6464,2954,2019,68.63,31.37
769,physical sciences,30524,18125,12399,2019,59.38,40.62
770,science technology,631,378,253,2019,59.9,40.1
771,psychology,116550,24317,92233,2019,20.86,79.14
772,"homeland security, law enforcement, firefighting and related protective service",57333,29147,28186,2019,50.84,49.16
773,public administration,35104,6089,29015,2019,17.35,82.65
774,social sciences,137504,64785,72719,2019,47.11,52.89
775,construction,208,184,24,2019,88.46,11.54
776,mechanic and repair,323,292,31,2019,90.4,9.6
777,precision production,47,23,24,2019,48.94,51.06
778,transportation and materials moving,5051,4435,616,2019,87.8,12.2
779,visual and performing arts,89741,33927,55814,2019,37.81,62.19
780,health professions and related programs,251566,39476,212090,2019,15.69,84.31
781,"business, management, marketing and related support services",389684,207746,181938,2019,53.31,46.69
782,history,23174,13832,9342,2019,59.69,40.31
783,all fields,2038682,861384,1177298,2020,42.25,57.75
784,agricultural animal plant veterinary science and related fields,21346,8624,12722,2020,40.4,59.6
785,natural resources,20512,9267,11245,2020,45.18,54.82
786,architecture,9045,4695,4350,2020,51.91,48.09
787,"area, ethnic, cultural, gender and group studies",7771,2072,5699,2020,26.66,73.34
788,"communication, journalism and related programs",91763,32897,58866,2020,35.85,64.15
789,communications technologies technicians and support services,4424,2507,1917,2020,56.67,43.33
790,computer science,97054,76337,20717,2020,78.65,21.35
791,"culinary, entertainment and personal services",710,240,470,2020,33.8,66.2
792,education,85052,15191,69861,2020,17.86,82.14
793,engineering,128337,97740,30597,2020,76.16,23.84
794,engineering,19375,16639,2736,2020,85.88,14.12
795,"foreign languages, literatures and linguistics",16309,5041,11268,2020,30.91,69.09
796,family and consumer sciences,23248,2773,20475,2020,11.93,88.07
797,law,4262,1293,2969,2020,30.34,69.66
798,english language and literature,38049,10605,27444,2020,27.87,72.13
799,"liberal arts and sciences, general studies and humanities",42922,15232,27690,2020,35.49,64.51
800,library science,118,13,105,2020,11.02,88.98
801,biological sciences,126616,44977,81639,2020,35.52,64.48
802,mathematics,27227,15784,11443,2020,57.97,42.03
803,military technologies and applied sciences,1156,927,229,2020,80.19,19.81
804,multi/interdisciplinary studies,55037,18994,36043,2020,34.51,65.49
805,"parks, recreation, leisure, fitness and kinesiology",53749,27255,26494,2020,50.71,49.29
806,philosophy and religious studies,11898,7979,3919,2020,67.06,32.94
807,theology,6855,4036,2819,2020,58.88,41.12
808,physical sciences,30172,17187,12985,2020,56.96,43.04
809,science technology,571,286,285,2020,50.09,49.91
810,psychology,119989,24817,95172,2020,20.68,79.32
811,civil service,57044,28236,28808,2020,49.5,50.5
812,public administration,34352,5870,28482,2020,17.09,82.91
813,social sciences,137998,64287,73711,2020,46.59,53.41
814,construction,174,155,19,2020,89.08,10.92
815,mechanic and repair,239,219,20,2020,91.63,8.37
816,precision production,39,16,23,2020,41.03,58.97
817,transportation and materials moving,5251,4565,686,2020,86.94,13.06
818,visual and performing arts,92299,34057,58242,2020,36.9,63.1
819,health professions and related programs,257327,39666,217661,2020,15.41,84.59
820,"business, management, marketing and related support services",387171,207282,179889,2020,53.54,46.46
821,history,23221,13623,9598,2020,58.67,41.33
822,all fields,2066463,860797,1205666,2021,41.66,58.34
823,agricultural animal plant veterinary science and related fields,21414,8457,12957,2021,39.49,60.51
824,natural resources,20507,8951,11556,2021,43.65,56.35
825,architecture,9296,4703,4593,2021,50.59,49.41
826,"area, ethnic, cultural, gender and group studies",7390,1882,5508,2021,25.47,74.53
827,"communication, journalism and related programs",90761,32716,58045,2021,36.05,63.95
828,communications technologies technicians and support services,4556,2398,2158,2021,52.63,47.37
829,computer science,104883,81926,22957,2021,78.11,21.89
830,"culinary, entertainment and personal services",594,208,386,2021,35.02,64.98
831,education,89477,15407,74070,2021,17.22,82.78
832,engineering,126042,95486,30556,2021,75.76,24.24
833,engineering,18562,15851,2711,2021,85.39,14.61
834,"foreign languages, literatures and linguistics",15514,4546,10968,2021,29.3,70.7
835,family and consumer sciences,22319,2640,19679,2021,11.83,88.17
836,law,4585,1321,3264,2021,28.81,71.19
837,english language and literature,35764,9821,25943,2021,27.46,72.54
838,"liberal arts and sciences, general studies and humanities",41827,14898,26929,2021,35.62,64.38
839,library science,119,11,108,2021,9.24,90.76
840,biological sciences,131515,45005,86510,2021,34.22,65.78
841,mathematics,27106,15720,11386,2021,57.99,42.01
842,military technologies and applied sciences,1524,1169,355,2021,76.71,23.29
843,multi/interdisciplinary studies,54615,19061,35554,2021,34.9,65.1
844,"parks, recreation, leisure, fitness and kinesiology",54268,27162,27106,2021,50.05,49.95
845,philosophy and religious studies,11989,7884,4105,2021,65.76,34.24
846,theology,6735,3965,2770,2021,58.87,41.13
847,physical sciences,28704,15931,12773,2021,55.5,44.5
848,science technology,532,273,259,2021,51.32,48.68
849,psychology,126950,25573,101377,2021,20.14,79.86
850,civil service,58006,27733,30273,2021,47.81,52.19
851,public administration,34817,5820,28997,2021,16.72,83.28
852,social sciences,137928,63049,74879,2021,45.71,54.29
853,construction,221,189,32,2021,85.52,14.48
854,mechanic and repair,221,209,12,2021,94.57,5.43
855,precision production,28,16,12,2021,57.14,42.86
856,transportation and materials moving,5993,5199,794,2021,86.75,13.25
857,visual and performing arts,90027,33166,56861,2021,36.84,63.16
858,health professions and related programs,267993,40742,227251,2021,15.2,84.8
859,"business, management, marketing and related support services",390758,208321,182437,2021,53.31,46.69
860,history,22923,13388,9535,2021,58.4,41.6
861,all fields,2014809,835231,1179578,2022,41.45,58.55
862,agricultural animal plant veterinary science and related fields,20259,7866,12393,2022,38.83,61.17
863,natural resources,20394,8715,11679,2022,42.73,57.27
864,architecture,9463,4679,4784,2022,49.45,50.55
865,"area, ethnic, cultural, gender and group studies",6664,1638,5026,2022,24.58,75.42
866,"communication, journalism and related programs",86064,31260,54804,2022,36.32,63.68
867,communications technologies technicians and support services,4851,2584,2267,2022,53.27,46.73
868,computer science,108511,83974,24537,2022,77.39,22.61
869,"culinary, entertainment and personal services",638,241,397,2022,37.77,62.23
870,education,89437,15046,74391,2022,16.82,83.18
871,engineering,123012,91911,31101,2022,74.72,25.28
872,engineering,18013,15265,2748,2022,84.74,15.26
873,"foreign languages, literatures and linguistics",13903,4218,9685,2022,30.34,69.66
874,family and consumer sciences,20630,2416,18214,2022,11.71,88.29
875,law,4426,1301,3125,2022,29.39,70.61
876,english language and literature,33429,9097,24332,2022,27.21,72.79
877,"liberal arts and sciences, general studies and humanities",37890,13154,24736,2022,34.72,65.28
878,library science,135,21,114,2022,15.56,84.44
879,biological sciences,131448,44387,87061,2022,33.77,66.23
880,mathematics,26198,15448,10750,2022,58.97,41.03
881,military technologies and applied sciences,1602,1263,339,2022,78.84,21.16
882,multi/interdisciplinary studies,52617,19319,33298,2022,36.72,63.28
883,"parks, recreation, leisure, fitness and kinesiology",52806,26759,26047,2022,50.67,49.33
884,philosophy and religious studies,11224,7420,3804,2022,66.11,33.89
885,theology,6388,3834,2554,2022,60.02,39.98
886,physical sciences,27856,15231,12625,2022,54.68,45.32
887,science technology,445,218,227,2022,48.99,51.01
888,psychology,129603,25772,103831,2022,19.89,80.11
889,civil service,56894,26258,30636,2022,46.15,53.85
890,public administration,33430,5349,28081,2022,16.0,84.0
891,social sciences,129665,58483,71182,2022,45.1,54.9
892,construction,203,178,25,2022,87.68,12.32
893,mechanic and repair,191,178,13,2022,93.19,6.81
894,precision production,12,8,4,2022,66.67,33.33
895,transportation and materials moving,6542,5620,922,2022,85.91,14.09
896,visual and performing arts,90248,33290,56958,2022,36.89,63.11
897,health professions and related programs,263746,39851,223895,2022,15.11,84.89
898,"business, management, marketing and related support services",374591,200477,174114,2022,53.52,46.48
899,history,21381,12502,8879,2022,58.47,41.53
900,all fields,1965343,816989,1148354,2023,41.57,58.43
901,agricultural animal plant veterinary science and related fields,20407,7585,12822,2023,37.17,62.83
902,natural resources,20919,8776,12143,2023,41.95,58.05
903,architecture,10167,4925,5242,2023,48.44,51.56
904,"area, ethnic, cultural, gender and group studies",6059,1457,4602,2023,24.05,75.95
905,"communication, journalism and related programs",78396,28608,49788,2023,36.49,63.51
906,communications technologies technicians and support services,4966,2724,2242,2023,54.85,45.15
907,computer science,113501,87388,26113,2023,76.99,23.01
908,"culinary, entertainment and personal services",648,230,418,2023,35.49,64.51
909,education,87253,14537,72716,2023,16.66,83.34
910,engineering,119040,88611,30429,2023,74.44,25.56
911,engineering,17513,14741,2772,2023,84.17,15.83
912,"foreign languages, literatures and linguistics",12923,3802,9121,2023,29.42,70.58
913,family and consumer sciences,18518,2152,16366,2023,11.62,88.38
914,law,4342,1239,3103,2023,28.54,71.46
915,english language and literature,31454,8615,22839,2023,27.39,72.61
916,"liberal arts and sciences, general studies and humanities",36833,13039,23794,2023,35.4,64.6
917,library science,138,13,125,2023,9.42,90.58
918,biological sciences,130327,43672,86655,2023,33.51,66.49
919,mathematics,25254,15083,10171,2023,59.73,40.27
920,military technologies and applied sciences,1616,1232,384,2023,76.24,23.76
921,multi/interdisciplinary studies,52610,19799,32811,2023,37.63,62.37
922,"parks, recreation, leisure, fitness and kinesiology",51317,26525,24792,2023,51.69,48.31
923,philosophy and religious studies,10874,7329,3545,2023,67.4,32.6
924,theology,5782,3306,2476,2023,57.18,42.82
925,physical sciences,26566,14654,11912,2023,55.16,44.84
926,science technology,404,192,212,2023,47.52,52.48
927,psychology,132990,26367,106623,2023,19.83,80.17
928,civil service,54100,24253,29847,2023,44.83,55.17
929,public administration,31517,4988,26529,2023,15.83,84.17
930,social sciences,124743,55520,69223,2023,44.51,55.49
931,construction,251,220,31,2023,87.65,12.35
932,mechanic and repair,194,183,11,2023,94.33,5.67
933,precision production,45,20,25,2023,44.44,55.56
934,transportation and materials moving,6797,5800,997,2023,85.33,14.67
935,visual and performing arts,89805,32682,57123,2023,36.39,63.61
936,health professions and related programs,251097,37365,213732,2023,14.88,85.12
937,"business, management, marketing and related support services",364628,196717,167911,2023,53.95,46.05
938,history,21349,12640,8709,2023,59.21,40.79
